2-amino-adipic_acid	O=C(O)C(N)CCCC(O)=O	Adenylation_substrate
Alanine	NC(C(O)=O)C	Adenylation_substrate
Beta-alanine	NCCC(=O)O	Adenylation_substrate
Arginine	NC(C(O)=O)CCCNC(N)=N	Adenylation_substrate
Asparagine	NC(C(O)=O)CC(N)=O	Adenylation_substrate
Aspartic_acid	NC(C(O)=O)CC(O)=O	Adenylation_substrate
Methyl_aspartic_acid	O=C(O)C(N)C(C)C(O)=O	Adenylation_substrate
Beta-hydroxytyrosine	OC(c1ccc(O)cc1)C(N)C(O)=O	Adenylation_substrate
(4R)-4[(E)-2-butenyl]-4-methyl-_L-threonine	NC(C(O)=O)C(C(C/C=C/C)C)O	Adenylation_substrate
Cysteine	NC(C(O)=O)CS	Adenylation_substrate
2,4-diamino-butyric_acid	O=C(O)C(N)CCN	Adenylation_substrate
2,3-dehydroaminobutyric_acid	C/C=C(N)/C(O)=O	Adenylation_substrate
2,3-dihydroxy-benzoic_acid	C1=CC(=C(C(=C1)O)O)C(=O)O	Adenylation_substrate
Salicylic_acid	C1=CC=C(C(=C1)C(=O)O)O	Adenylation_substrate
3,5-dihydroxyphenylglycine	O=C(C(C1=CC(O)=C(C=C1)O)N)O	Adenylation_substrate
Glutamine	NC(CCC(N)=O)C(O)=O	Adenylation_substrate
Glutamate	NC(CCC(O)=O)C(O)=O	Adenylation_substrate
Glycine	NCC(O)=O	Adenylation_substrate
Histidine	NC(C(O)=O)CC1=CN=CN1	Adenylation_substrate
4-hydroxyphenylglycine	NC(C1=CC=C(O)C=C1)C(O)=O	Adenylation_substrate
3,5-dichloro-4-hydroxy-L-phenylglycine	NC(C(O)=O)C1=CC(Cl)=C(C(Cl)=C1)O	Adenylation_substrate
Hydroxyvaline	O=C(O)C(N)C(O)(C)C	Adenylation_substrate
Isoleucine	NC(C(O)=O)C(CC)C	Adenylation_substrate
Isovaline/2-amino-butyric_acid	CCC(C)(C(=O)O)N	CCC(C(=O)O)N	Adenylation_substrate
Leucine	NC(C(O)=O)CC(C)C	Adenylation_substrate
Lysine	NC(C(O)=O)CCCCN	Adenylation_substrate
Beta-lysine	O=C(CC(CCCN)N)O	Adenylation_substrate
Ornithine	O=C(O)C(N)CCCN	Adenylation_substrate
N5-hydroxyornithine	O=C(O)C(N)CCCNO	Adenylation_substrate
Hydroxyacetyl-ornithine	O=C(C(CCCN(O)C(C)=O)N)O	Adenylation_substrate
Phenylalanine	NC(C(O)=O)CC1=CC=CC=C1	Adenylation_substrate
Phenylacetate	O=C(Cc1ccccc1)O	Adenylation_substrate
Pipecolic_acid	C1CCNC(C1)C(=O)O	Adenylation_substrate
Proline	OC(C1NCCC1)=O	Adenylation_substrate
Methyl-proline	O=C(O)C1NCC(C)C1	Adenylation_substrate
Serine	OCC(N)C(O)=O	Adenylation_substrate
Threonine	OC(C(N)C(O)=O)C	Adenylation_substrate
Allo-threonine	CC(O)C(N)C(O)=O	Adenylation_substrate
Tryptophan	NC(C(O)=O)CC1=CN(C2=C1C=CC=C2)[H]	Adenylation_substrate
Tyrosine	NC(CC1=CC=C(C=C1)O)C(O)=O	Adenylation_substrate
Valine	NC(C(C)C)C(O)=O	Adenylation_substrate
2-Methylbuteryl-CoA	IC(C(CC)(C)F)=O	Acyltransferase_substrate
Benzoyl-CoA	IC(C(F)c1ccccc1)=O	Acyltransferase_substrate
Ethylmalonyl-CoA	IC(C(CC)F)=O	Acyltransferase_substrate
Isobuteryl-CoA	IC(C(C)(C)F)=O	Acyltransferase_substrate
Malonyl-CoA	IC(CF)=O	Acyltransferase_substrate
Methylmalonyl-CoA	IC(C(C)F)=O	Acyltransferase_substrate
Methoxymalonyl-CoA	IC(C(OC)F)=O	Acyltransferase_substrate
Propionyl-CoA	IC(C(CC)F)=O	Acyltransferase_substrate
