A40926	CN[C@@H]1C2=CC(=C(C=C2)O)OC3=CC(=C(C(=C3)[C@H]4C(=O)N[C@@H]5C6=CC(=C(C(=C6)OC7=C(C=C(C=C7)[C@H]([C@H]8C(=O)N[C@@H](C9=CC(=CC(=C9C2=C(C=CC(=C2)[C@H](C(=O)N8)NC5=O)O)O)O)C(=O)O)O)Cl)O)OC2=CC=C(C[C@H](C(=O)N4)NC1=O)C=C2)Cl)O
Abyssomicin I	C[C@@H]1CCC(=O)C2=C3[C@]4(C[C@H]([C@](O3)([C@@H]([C@H]4/C=C/[C@H]1O)O)C)C)OC2=O
Andrimid	C/C=C/C=C/C=C/C(=O)N[C@@H](CC(=O)N[C@@H](C(C)C)C(=O)[C@@H]1[C@H](C(=O)NC1=O)C)C2=CC=CC=C2
Antibiotic TA	CCCC1C(=O)NCC(CC(C(CC/C(=C/C=C/C(CCCC(=O)CCCCC(CC(C(=O)O1)C)C)CC)/COC)O)O)O
Anticapsin	C1CC(=O)[C@H]2[C@@H]([C@H]1C[C@@H](C(=O)O)N)O2
Argyrin A	CC[C@@H]1C2=NC(=CS2)C(=O)N[C@H](C(=O)N[C@H](C(=O)NCC(=O)N[C@@H](C(=O)NC(=C)C(=O)N(CC(=O)N1)C)C)CC3=CNC4=C3C(=CC=C4)OC)CC5=CNC6=CC=CC=C65
Arylomycin A2	C[C@H]1C(=O)N[C@@H](CC2=CC(=C(C=C2)O)C3=C(C=CC(=C3)[C@@H](C(=O)N1)N(C)C(=O)CNC(=O)[C@@H](C)NC(=O)[C@@H](CO)N(C)C(=O)C)O)C(=O)O
Arylomycin B-C16	CCCCCCCCCCCCCCCC(=O)N(C)[C@H](CO)C(=O)N[C@H](C)C(=O)NCC(=O)N(C)[C@H]1C2=CC(=C(C=C2)O)C3=CC(=CC(=C3O)[N+](=O)[O-])C[C@H](NC(=O)[C@@H](NC1=O)C)C(=O)O
Arylomycin C16	CCCCCCCCCCCCCCCC(=O)N(C)[C@H](CO)C(=O)N[C@H](C)C(=O)NCC(=O)N(C)[C@H]1C2=CC(=C(C=C2)O)C3=C(C=CC(=C3)C[C@H](NC(=O)[C@@H](NC1=O)C)C(=O)O)O
Astromicin	CC([C@@H]1CC[C@H]([C@H](O1)O[C@@H]2[C@H]([C@@H]([C@@H]([C@H]([C@H]2O)N(C)C(=O)CN)OC)O)N)N)N
Avoparcin	C[C@H]1[C@@H]([C@@H](C[C@@H](O1)O[C@H]2[C@H]3C(=O)N[C@@H](C4=CC(=CC(=C4C5=C(C=CC(=C5)[C@H](C(=O)N3)NC(=O)[C@H]6C7=CC(=C(C(=C7)OC8=C(C=C2C=C8)Cl)O[C@H]9C([C@H]([C@@H]([C@H](O9)CO)O)O)O[C@H]1C[C@H]([C@H]([C@@H](O1)C)O)N)OC1=CC=C(C=C1)[C@H]([C@H](C(=O)N[C@H](C(=O)N6)C1=CC=C(C=C1)O)NC(=O)[C@@H](C1=CC=C(C=C1)O[C@H]1[C@@H]([C@@H]([C@H]([C@@H](O1)C)O)O)O)NC)O)O)O)O)C(=O)O)N)O
Bacillaene	CC(C)CC(C(=O)NCCC/C=C\C=C\C(=C\C=C/C=C(/C)\C(CC(=O)N/C(=C\C=C\C=C\C(C)C(=O)O)/C)O)\C)O
Bacitracin	CC[C@H](C)[C@H](N)C1=N[C@@H](CS1)C(=O)N[C@@H](CC(C)C)C(=O)N[C@H](CCC(O)=O)C(=O)N[C@@H]([C@@H](C)CC)C(=O)N[C@H]1CCCCNC(=O)[C@H](CC(N)=O)NC(=O)[C@@H](CC(O)=O)NC(=O)[C@H](CC2=CNC=N2)NC(=O)[C@@H](CC2=CC=CC=C2)NC(=O)[C@@H](NC(=O)[C@@H](CCCN)NC1=O)[C@@H](C)CC
Bambermycins	C[C@@H]1[C@H]([C@@H]([C@H]([C@@H](O1)O[C@@H]2[C@H](O[C@H]([C@@H]([C@H]2O)NC(=O)C)O[C@@H]3[C@H]([C@]([C@H](O[C@@H]3OP(=O)(O)OC[C@H](C(=O)OCC/C=C(\C)/CC/C=C/C(C)(C)CCC(=C)C/C=C(\C)/CCC=C(C)C)O)C(=O)O)(C)O)OC(=O)N)CO[C@H]4[C@@H]([C@H]([C@@H]([C@H](O4)CO)O)O)O)NC(=O)C)O)O[C@H]5[C@@H]([C@H]([C@H]([C@H](O5)C(=O)NC6=C(CCC6=O)O)O)O)O
Bottromycin A2	CC1CCN2C1C(=O)NC(C(=O)NC(C(=NCC2=O)NC(C(=O)NC(C(C)C3=CC=CC=C3)C(=O)NC(CC(=O)OC)C4=NC=CS4)C(C)(C)C)C(C)(C)C)C(C)C
Calcium Dependent Antibiotic (CDA)	CCCC1C(O1)C(=O)N[C@@H](CO)C(=O)N[C@H]2C(OC(=O)[C@@H](NC(=O)[C@@H](NC(=O)[C@H](NC(=O)CNC(=O)[C@@H](NC(=O)[C@H](NC(=O)[C@@H](NC(=O)[C@@H](NC(=O)[C@H](NC2=O)CC3=CNC4=CC=CC=C43)CC(=O)O)CC(=O)O)C5=CC=C(C=C5)O)CC(=O)O)[C@@H](C(=O)N)O)C(C)CC(=O)O)CC6=CNC7=CC=CC=C76)C
Capreomycin	[H][C@@]1(CCN=C(N)N1)[C@]1([H])NC(=O)\C(NC(=O)[C@H](CNC(=O)C[C@@H](N)CCCN)NC(=O)[C@H](C)NC(=O)[C@@H](N)CNC1=O)=C/NC(N)=O.[H][C@@]1(CCN=C(N)N1)[C@]1([H])NC(=O)\C(NC(=O)[C@H](CNC(=O)C[C@@H](N)CCCN)NC(=O)[C@H](CO)NC(=O)[C@@H](N)CNC1=O)=C/NC(N)=O
Cefmetazole	O=C2N1/C(=C(\CS[C@@H]1[C@]2(OC)NC(=O)CSCC#N)CSc3nnnn3C)C(=O)O
Cefotetan	O=C2N1/C(=C(\CS[C@@H]1[C@]2(OC)NC(=O)C3S/C(S3)=C(/C(=O)N)C(=O)O)CSc4nnnn4C)C(=O)O
Cefoxitin	O=C2N1/C(=C(\CS[C@@H]1[C@]2(OC)NC(=O)Cc3sccc3)COC(=O)N)C(=O)O
Ceftriaxone	[H][C@]12SCC(CSC3=NC(=O)C(=O)NN3C)=C(N1C(=O)[C@H]2NC(=O)C(=N/OC)\C1=CSC(N)=N1)C(O)=O
Cephalosporin C	CC(=O)OCC1=C(N2[C@@H](SC1)[C@H](NC(=O)CCC[C@H]([NH3+])C(O)=O)C2=O)C(O)=O
Cervimycin A	C[C@@H]1[C@H](CC[C@@H](O1)O[C@H]2CC[C@@H](O[C@@H]2C)O[C@]34[C@H](CC5=C(C3=O)C(=C6C(=C5)C(=O)C(=CC6=O)OC)O)[C@H](C(=O)C(=C4O)C(=O)C)O[C@H]7CC[C@@H]([C@H](O7)C)O[C@H]8CC[C@@H]([C@@H](O8)C)O[C@H]9CC[C@@H]([C@@H](O9)C)O[C@H]1CC[C@@H]([C@@H](O1)C)OC(=O)C(C)(C)C(=O)O)O
Chloramphenicol	OC[C@@H](NC(=O)C(Cl)Cl)[C@H](O)C1=CC=C(C=C1)[N+]([O-])=O
chloroeremomycin	C[C@H]1[C@@H]([C@@](C[C@@H](O1)O[C@@H]2[C@H]([C@@H]([C@H](O[C@H]2OC3=C4C=C5C=C3OC6=C(C=C(C=C6)[C@H]([C@H](C(=O)N[C@H](C(=O)N[C@H]5C(=O)N[C@@H]7C8=CC(=C(C=C8)O)C9=C(C=C(C=C9[C@H](NC(=O)[C@H]([C@@H](C1=CC(=C(O4)C=C1)Cl)O[C@H]1C[C@]([C@H]([C@@H](O1)C)O)(C)N)NC7=O)C(=O)O)O)O)CC(=O)N)NC(=O)[C@@H](CC(C)C)NC)O)Cl)CO)O)O)(C)N)O
Chlorotetracycline	C[C@@]1([C@H]2C[C@H]3[C@@H](C(=O)C(=C([C@]3(C(=O)C2=C(C4=C(C=CC(=C41)Cl)O)O)O)O)C(=O)N)N(C)C)O
Chlorthioamide	S=C(c1c(Cl)cccc1Cl)N
Clavulanic acid	[H][C@@]12CC(=O)N1[C@@H](C(O)=O)\C(O2)=C\CO
Colisitin	O=C(N[C@H](C(=O)N[C@H](C(=O)N[C@H](C(=O)N[C@@H]1C(=O)N[C@H](C(=O)N[C@@H](C(=O)N[C@H](C(=O)N[C@H](C(=O)N[C@H](C(=O)N[C@H](C(=O)NCC1)[C@H](O)C)CCN)CCN)CC(C)C)CC(C)C)CCN)CCN)[C@H](O)C)CCN)CCCC(C)CC
Complestatin	[H][C@]1(Cc2ccc(Oc3cc4cc(-c5ccc6C(C[C@@H](NC(=O)C(=O)c7cc(Cl)c(O)c(Cl)c7)C(=O)N[C@@H](C(=O)N[C@@]4([H])C(=O)N[C@@H](C(=O)N1C)c1cc(Cl)c(O)c(Cl)c1)c1cc(Cl)c(O)c(Cl)c1)C(=O)Nc6c5)c3O)cc2)C(=O)N[C@@H](C(O)=O)c1ccc(O)cc1
Corallopyronin	C/C=C/C/C=C(\C)/C(CC/C(=C/C=C(\C)/C(=C/1\C(=O)C=C(OC1=O)C(C)CC/C=C/NC(=O)OC)/O)/C)O
Cycloserine	N[C@@H]1CONC1=O
Cyclothialidine	CC1=C(C=C(C2=C1C(=O)OC[C@@H](C(=O)N[C@@H](CSC2)C(=O)N[C@@H](C)C(=O)O)NC(=O)[C@@H]3[C@@H](CCN3C(=O)C(CO)N)O)O)O
Daptomycin	CCCCCCCCCC(=O)N[C@@H](CC1=CNC2=C1C=CC=C2)C(=O)N[C@@H](CC(N)=O)C(=O)N[C@@H](CC(O)=O)C(=O)N[C@H]1[C@@H](C)OC(=O)[C@H](CC(=O)C2=CC=CC=C2N)NC(=O)[C@@H](NC(=O)[C@@H](CO)NC(=O)CNC(=O)[C@H](CC(O)=O)NC(=O)[C@@H](C)NC(=O)[C@H](CC(O)=O)NC(=O)[C@H](CCCN)NC(=O)CNC1=O)[C@H](C)CC(O)=O
Dehydrophos*	CC(C)CC(C(=O)NC(=C)P(=O)([O-])OC)NC(=O)C[NH3+]
Enacyloxin IIA	CC/C=C/[C@H]([C@H]([C@@H](CC(=O)C(C([C@H](C)/C(=C/C=C/C=C(\C)/C=C/C=C/C(=O)O[C@@H]1C[C@H](CC[C@@H]1O)C(=O)O)/Cl)O)O)O)Cl)OC(=O)N
Enacyloxin IVA	CC/C=C/C(C(C(CC(C(C(C(C)/C(=C/C=C/C=C(\C)/C=C/C=C/C(=O)OC1CC(CCC1O)C(=O)O)/Cl)O)O)O)O)Cl)OC(=O)N
Enduracidine	CC1C(C(=O)NC(C(=O)NC(C(=O)NC(C(=O)NC(C(=O)NC(C(=O)NC(C(=O)NC(C(=O)NC(C(=O)NC(C(=O)NC(C(=O)NC(C(=O)NCC(=O)NC(C(=O)NC(C(=O)NC(C(=O)O1)C2=CC=C(C=C2)O)C)CC3CNC(=N3)N)C4=CC(=C(C(=C4)Cl)O)Cl)CO)C5=CC=C(C=C5)O)CC6CNC(=N6)N)CCCNC(=O)N)C(C)O)C7=CC=C(C=C7)O)C8=CC=C(C=C8)O)C(C)O)CCCN)C9=CC=C(C=C9)O)NC(=O)C(CC(=O)O)NC(=O)/C=C\C=C\CCCCC(C)C
Enterocin	COC1=CC(=O)OC(=C1)C2C3(CC4C(C2([C@@H]([C@]3(C(=O)O4)O)C(=O)C5=CC=CC=C5)O)O)O
Fidaxomicin	CC[C@H]1/C=C(/[C@H](C/C=C/C=C(/C(=O)O[C@@H](C/C=C(/C=C(/[C@@H]1O[C@H]2[C@H]([C@H]([C@@H](C(O2)(C)C)OC(=O)C(C)C)O)O)\C)\C)[C@@H](C)O)\CO[C@H]3[C@H]([C@H]([C@@H]([C@H](O3)C)OC(=O)C4=C(C(=C(C(=C4O)Cl)O)Cl)CC)O)OC)O)\C
Fosfomycin	C[C@@H]1O[C@@H]1P(O)(O)=O
Fosmidomycin*	C(CN(C=O)O)CP(=O)(O)O
Friulimicin B	C[C@H]1[C@@H](C(=O)N2CCCC[C@@H]2C(=O)N[C@H](C(=O)N[C@H](C(=O)NCC(=O)N[C@H](C(=O)NCC(=O)N[C@@H](C(=O)N[C@H](C(=O)N3CCC[C@H]3C(=O)N1)C(C)C)[C@@H](C)N)CC(=O)O)CC(=O)O)[C@H](C)C(=O)O)NC(=O)[C@H](CC(=O)N)NC(=O)C/C=C\CCCCCCCC(C)C
Gentamicin	CNC(C)C1CCC(N)C(OC2C(N)CC(N)C(OC3OCC(C)(O)C(NC)C3O)C2O)O1
Globomycin	CCCCCC[C@@H]1[C@H](C(=O)N([C@H](C(=O)N[C@H](C(=O)N[C@@H](C(=O)N[C@@H](C(=O)NCC(=O)O1)[C@H](C)O)CO)[C@H](C)CC)CC(C)C)C)C
Gramicidin	C[C@@H](C(=O)N[C@H](CC(C)C)C(=O)N[C@@H](C)C(=O)N[C@H](C(C)C)C(=O)N[C@@H](C(C)C)C(=O)N[C@@H](C(C)C)C(=O)N[C@@H](CC1=CNC2=CC=CC=C21)C(=O)N[C@H](CC(C)C)C(=O)N[C@@H](CC3=CNC4=CC=CC=C43)C(=O)N[C@H](CC(C)C)C(=O)N[C@@H](CC5=CNC6=CC=CC=C65)C(=O)N[C@H](CC(C)C)C(=O)N[C@@H](CC7=CNC8=CC=CC=C87)C(=O)NCCO)NC(=O)CNC(=O)[C@H](C(C)C)NC=O
Herbicolin A	CCCCCCCCCCCC(CC(=O)N/C(=C/C)/C(=O)NC1C(OC(=O)C(NC(=O)C(N(C(=O)CNC(=O)C(NC(=O)CNC(=O)C(NC(=O)C(NC1=O)C(C)O)CC(C)C)CCC(=O)N)C)C(C)O)CCCN=C(N)N)C)OC2C(C(C(C(O2)CO)O)O)O
Herbicolin B	CCCCCCCCCCCC(CC(=O)N/C(=C\C)/C(=O)NC1C(OC(=O)C(NC(=O)C(N(C(=O)CNC(=O)C(NC(=O)CNC(=O)C(NC(=O)C(NC1=O)C(C)O)CC(C)C)CCC(=O)N)C)C(C)O)CCCN=C(N)N)C)O
Hormaomycin*	CC=CC1CN2C(C1)C(=O)OC(C)C(NC(=O)C(NC(=O)c1ccc(n1O)Cl)CC1CC1N(=O)=O)C(=O)NC(C(=O)NC(C(=O)NC(C(=O)NC(C2=O)C(CC)C)C(c1ccccc1)C)CC1CC1N(=O)=O)C(c1ccccc1)C
Hyaladione	CSC1=CC(=O)C(=C(C1=O)Cl)N
Janthinocin A	CCC(C)C(C(=O)NC1C(OC(=O)C(NC(=O)C(NC(=O)C(NC(=O)C(NC(=O)/C(=C/C)/NC(=O)C(NC(=O)C(NC(=O)C(NC1=O)C(C)O)CO)C(C(C)C)O)CO)C(C2=CNC3=CC=CC=C32)O)CCCN)CC4=CC=CC=C4)C(C)C)N
Janthinocin B	CCC(C)C(C(=O)NC1C(OC(=O)C(NC(=O)C(NC(=O)/C(=C(/C2=CNC3=CC=CC=C32)\O)/NC(=O)C(NC(=O)/C(=C/C)/NC(=O)C(NC(=O)C(NC(=O)C(NC1=O)C(C)O)CO)C(C(C)C)O)CO)CCCN)CC4=CC=CC=C4)C(C)C)N
Janthinocin C	CCC(C)C(C(=O)NC1C(OC(=O)C(NC(=O)C(NC(=O)/C(=C/C2=CNC3=CC=CC=C32)/NC(=O)C(NC(=O)/C(=C/C)/NC(=O)C(NC(=O)C(NC(=O)C(NC1=O)C(C)O)CO)C(C(C)C)O)CO)CCCN)CC4=CC=CC=C4)C(C)C)N
Kanamycin	NC[C@H]1O[C@H](O[C@@H]2[C@@H](N)C[C@@H](N)[C@H](O[C@H]3O[C@H](CO)[C@@H](O)[C@H](N)[C@H]3O)[C@H]2O)[C@H](O)[C@@H](O)[C@@H]1O
Katanosin A	CC(C)CC1C(=O)NC(C(=O)NC(C(=O)NC(C(=O)NCC(=O)NC(C(=O)NC(C(=O)OC(C(C(=O)NC(C(=O)N1)C(C(C)C)O)NC(=O)C(CC(C)C)NC(=O)C(CC(C)C)N)C2=CC=CC=C2)CO)C(C(=O)N)O)C(C)O)C(C)C)CCCN=C(N)N
Katanosin B	CCC(C)C1C(=O)NC(C(=O)NCC(=O)NC(C(=O)NC(C(=O)OC(C(C(=O)NC(C(=O)NC(C(=O)NC(C(=O)N1)CCCN=C(N)N)CC(C)C)C(C(C)C)O)NC(=O)C(CC(C)C)NC(=O)C(CC(C)C)N)C2=CC=CC=C2)CO)C(C(=O)N)O)C(C)O
Kibdelomycin	C[C@H]1C=C[C@H]2[C@@H](CCC(=C)[C@@H]2C1/C(=C/3\C(=O)[C@@H](N(C3=O)[C@@H]4[C@H]([C@H]([C@H]([C@H](O4)C)OC(=O)N)OC(=O)C)OC)C(C)C)/O)O[C@H]5C[C@]([C@@H]([C@H](O5)C)O)([C@H](C)NC(=O)C6=C(C(=C(N6)C)Cl)Cl)O
Kirromycin	CC[C@H](C(=O)NC/C=C/C=C(\C)/[C@H]([C@@H](C)[C@H]1[C@H]([C@H]([C@H](O1)/C=C/C=C/C=C(\C)/C(=C\2/C(=O)C=CNC2=O)/O)O)O)OC)[C@@]3([C@@H]([C@@H](C([C@@H](O3)/C=C/C=C/C)(C)C)O)O)O
Laspartomycin C	CC[C@@H](C)[C@H]1C(=O)N2CCC[C@H]2C(=O)NC[C@@H](C(=O)N3CCCC[C@H]3C(=O)NCC(=O)N[C@H](C(=O)NCC(=O)N[C@H](C(=O)NCC(=O)N[C@H](C(=O)N1)[C@@H](C)O)CC(=O)O)CC(=O)O)NC(=O)[C@H](CC(=O)O)NC(=O)/C=C/CCCCCCCCCC(C)C
Lincomycin	[H][C@@]1(O[C@]([H])([C@H](NC(=O)C2C[C@@H](CCC)CN2C)[C@@H](C)O)[C@H](O)[C@H](O)[C@H]1O)SC
lotilibcin	CC(C)CCC[C@@H]1CC(=O)N[C@H](C(=O)N[C@@H](C(=O)N[C@H](C(=O)NCC(=O)N([C@@H](C(=O)N[C@H](C(=O)N[C@@H](C(=O)N[C@H](C(=O)N[C@@H](C(=O)N[C@@H](C(=O)N[C@@H](C(=O)N([C@H](C(=O)O1)C(C)C)C)CCCN)CC2=CNC3=CC=CC=C32)CC(=O)N)CCC(=O)O)CCCN)CC(C)C)CC4=CC=CC=C4)C)CO)[C@H](C(=O)N)O)CO
Mannopeptimycin*	CC(C)CC(=O)OC1(C(O)C(CO)OC(C(O)1)OC2(C(O)C(O)C(OC(CO)2)OC3(C=CC(=CC=3)CC6(C(=O)N[CH](C(O)[CH]4(C[N+]=C(N)N4))C(=O)N[CH](C(=O)NC(CO)C(=O)NCC(=O)N[CH](C(C)C5(C=CC=CC=5))C(=O)N6)C(O)[CH]7(C[N+]=C(N)N7C8(C(O)C(O)C(C(O)O8)O))))))
Mupirocin	C[C@H](O)[C@H](C)[C@@H]1O[C@H]1C[C@H]1CO[C@@H](C\C(C)=C\C(=O)OCCCCCCCCC(O)=O)[C@H](O)[C@@H]1O
Myxopyronin A	CCC/C(=C/C=C(\C)/C(=C\1/C(=O)C=C(OC1=O)[C@H](C)CC/C=C/NC(=O)OC)/O)/C
Myxopyronin B	CCCC/C(=C/C=C(\C)/C(=C\1/C(=O)C=C(OC1=O)[C@H](C)CC/C=C/NC(=O)OC)/O)/C
Neomycin	NC[C@@H]1O[C@H](O[C@@H]2[C@@H](CO)O[C@@H](O[C@@H]3[C@@H](O)[C@H](N)C[C@H](N)[C@H]3O[C@H]3O[C@H](CN)[C@@H](O)[C@H](O)[C@H]3N)[C@@H]2O)[C@H](N)[C@@H](O)[C@@H]1O
Nocardicin A	C1[C@@H](C(=O)N1[C@H](C2=CC=C(C=C2)O)C(=O)[O-])NC(=O)/C(=N\O)/C3=CC=C(C=C3)OCC[C@H](C(=O)[O-])[NH3+]
Novobiocin	CO[C@@H]1[C@@H](OC(N)=O)[C@@H](O)[C@H](OC2=C(C)C3=C(C=C2)C(O)=C(NC(=O)C2=CC=C(O)C(CC=C(C)C)=C2)C(=O)O3)OC1(C)C
Oxytetracycline	[H][C@@]12[C@@H](O)[C@@]3([H])C(C(=O)C4=C(O)C=CC=C4[C@@]3(C)O)=C(O)[C@]1(O)C(=O)C(C(N)=O)=C(O)[C@H]2N(C)C
Paromomycin	NC[C@@H]1O[C@H](O[C@@H]2[C@@H](CO)O[C@@H](O[C@@H]3[C@@H](O)[C@H](N)C[C@H](N)[C@H]3O[C@H]3O[C@H](CO)[C@@H](O)[C@H](O)[C@H]3N)[C@@H]2O)[C@H](N)[C@@H](O)[C@@H]1O
Partricin	C[C@H]1[C@@H]([C@H]([C@H]([C@H](O1)OC2CC3C(C(CC(O3)(CC(CC(CC(CC(CC(=O)CC(CC(=O)OC(C(C=CC=CC=CC=CC=CC=CC=C2)C)C(C)CCC(CC(=O)C4=CC=C(C=C4)N)O)O)O)O)O)O)O)O)C(=O)O)O)N)O
Penicillin G	[H][C@]12SC(C)(C)[C@@H](N1C(=O)[C@H]2NC(=O)CC1=CC=CC=C1)C(O)=O
Phosphinothricin*	CP(=O)(CCC(C(=O)O)N)O
Platensimycin	[H][C@]12C[C@]3([H])O[C@@]1(C)C[C@@]1(C2)C=CC(=O)[C@@](C)(CCC(=O)NC2=C(O)C(=CC=C2O)C(O)=O)[C@]31[H]
Pleuromutilin	C[C@@H]1CC[C@@]23CCC(=O)[C@H]2[C@]1([C@@H](C[C@@]([C@H]([C@@H]3C)O)(C)C=C)OC(=O)CO)C
Plicamycin	CO[C@@H]([C@@H]1CC2=CC3=CC(O[C@H]4C[C@@H](O[C@H]5C[C@@H](O)[C@H](O)[C@@H](C)O5)[C@H](O)[C@@H](C)O4)=C(C)C(O)=C3C(O)=C2C(=O)[C@H]1O[C@H]1C[C@@H](O[C@H]2C[C@@H](O[C@H]3C[C@](C)(O)[C@H](O)[C@@H](C)O3)[C@@H](O)[C@@H](C)O2)[C@H](O)[C@@H](C)O1)C(=O)[C@@H](O)[C@@H](C)O
Plumbemycin A	CC(C(=O)NC(CC(=O)O)C(=O)NC(/C=C/CP(=O)(O)O)C(=O)O)N
Plumbemycin B	CC(C(=O)NC(CC(=O)N)C(=O)NC(/C=C/CP(=O)(O)O)C(=O)O)N
Polymyxin B	CCC(C)CCCCC(=O)N[C@@H](CCN)C(=O)N[C@@H]([C@@H](C)O)C(=O)N[C@@H](CCN)C(=O)N[C@H]1CCNC(=O)[C@@H](NC(=O)[C@@H](NC(=O)[C@@H](NC(=O)[C@@H](NC(=O)[C@H](NC(=O)[C@H](NC1=O)CCN)CC2=CC=CC=C2)CC(C)C)CCN)CCN)[C@@H](C)O
Ramoplanin	CCC/C=C\C=C/C(=O)N[C@@H](CC(=O)N)C(=O)NC(CC(=O)N)C(=O)N[C@H](C1CCC(CC1)O)C(=O)N[C@H](CCCN)C(=O)N[C@H]([C@H](C)O)C(=O)N[C@H](C2CCC(CC2)O)C(=O)N[C@H](C3CCC(CC3)O)C(=O)N[C@@H]([C@H](C)O)C(=O)N[C@@H](CC4=CC=CC=C4)C(=O)N[C@H](CCCN)C(=O)NC(C5CCC(CC5)O)C(=O)N[C@@H]([C@H](C)O)C(=O)NC(C6CCC(CC6)O)C(=O)NCC(=O)N[C@@H](CC(C)C)C(=O)N[C@H](C)C(=O)NC(C7CCC(C(C7)Cl)O)C(=O)O
Rifampicin	CN1CCN(CC1)/N=C/c2c(O)c3c5C(=O)[C@@]4(C)O/C=C/[C@H](OC)[C@@H](C)[C@@H](OC(C)=O)[C@H](C)[C@H](O)[C@H](C)[C@@H](O)[C@@H](C)\C=C\C=C(\C)C(=O)Nc2c(O)c3c(O)c(C)c5O4
Ristocetin	C[C@H]1[C@@H]([C@@H](C[C@H](O1)O[C@H]2[C@H]3C(=O)N[C@@H](C4=CC(=CC(=C4C5=C(C=CC(=C5)[C@H](C(=O)N3)NC(=O)[C@H]6C7=CC(=C(C(=C7)OC8=CC=C2C=C8)O[C@H]9[C@@H]([C@H]([C@@H]([C@H](O9)COC1[C@@H]([C@@H]([C@H]([C@@H](O1)C)O)O)O)O)O)O[C@H]1[C@@H]([C@@H]([C@H]([C@@H](O1)CO)O)O)O[C@H]1[C@H]([C@@H]([C@@H](CO1)O)O)O)OC1=CC=C(C=C1)[C@H]([C@@H]1C(=O)N[C@@H](C2=CC(=C(C(=C2)O)C)OC2=C(C=CC(=C2)[C@H](C(=O)N1)N)O)C(=O)N6)O)O)O[C@H]1[C@H]([C@H]([C@@H]([C@H](O1)CO)O)O)O)O)C(=O)OC)N)O
Rubradirin	CC1/C=C(/C(=O)C2=C3C(=CC(=C2O)C)C(=O)C4=C(C3=O)OC(CN4)(C(=O)C(C1OC(=O)C5=C(C(=CC(=N5)C(=O)NC6=C(C7=C(C=C(C=C7)OC)OC6=O)O)OC8CC(C(C(O8)C)OC)(C)[N+](=O)[O-])O)O)C)\C
Siphonazole*	[H]C(=O)C=1N=C(OC=1C([H])([H])[H])C([H])=C([H])C=2C([H])=C([H])C(OC([H])([H])[H])=C(OC([H])([H])[H])C=2([H])
Sorangicin A	C[C@H]1[C@H]2C/C=C/[C@H]3[C@@H]([C@H]4C[C@@H](O3)[C@H](O4)/C=C/C=C\C=C/C(=O)O[C@H]5C=C[C@H](C/C=C/CC/C=C/[C@@H]([C@@H]([C@H](O2)C[C@@H]1O)O)O)O[C@H]5/C(=C/[C@H](C)CCCCC(=O)O)/C)C
Sorangicin B	CC1C2C/C=C/C3C(C4CC(O3)C(O4)/C=C\C=C/C=C\C(=O)OC5C=CC(C/C=C/CC/C=C/C(CC(O2)CC1O)O)OC5/C(=C/C(C)CCCCC(=O)O)/C)C
Spectinomycin	[H][C@@]12O[C@H](C)CC(=O)[C@]1(O)O[C@]1([H])[C@@H](NC)[C@@H](O)[C@@H](NC)[C@H](O)[C@@]1([H])O2
Streptogramin B*	CCC1C(=O)N2CCCC2C(=O)N(C(C(=O)N3CCC(=O)CC3C(=O)NC(C(=O)OC(C(C(=O)N1)NC(=O)C4=C(C=CC=N4)O)C)C5=CC=CC=C5)CC6=CC=C(C=C6)N(C)C)C
Streptolydigin	C[C@H]1[C@H]2C=C[C@@]3(CO3)[C@](O2)(O[C@@H]1[C@H](C)/C=C(\C)/C=C/C(=C\4/C(=O)[C@@H](N(C4=O)[C@@H]5CC[C@@H]([C@@H](O5)C)O)[C@H](C)C(=O)NC)/O)C
Streptomycin	CN[C@H]1[C@H](O)[C@@H](O)[C@H](CO)O[C@H]1O[C@H]1[C@H](O[C@H]2[C@H](O)[C@@H](O)[C@H](NC(N)=N)[C@@H](O)[C@@H]2NC(N)=N)O[C@@H](C)[C@]1(O)C=O
Tagetitoxin	CC(=O)O[C@@H]1[C@H](N)[C@@H](OP(O)(O)=O)[C@]2(CS[C@](O)([C@@H]1O2)C(N)=O)C(O)=O
Tauramamide	CC(C)CCCCCC(=O)N[C@H](CC1=CC=C(C=C1)O)C(=O)N[C@@H](CO)C(=O)N[C@H](CC(C)C)C(=O)N[C@@H](CC2=CNC3=CC=CC=C32)C(=O)N[C@@H](CCCN=C(N)N)C(=O)O
Teicoplanin	CCCCCCCCCC(=O)N[C@@H]1[C@H]([C@@H]([C@H](O[C@H]1OC2=C3C=C4C=C2OC5=C(C=C(C=C5)[C@H]([C@H]6C(=O)N[C@H](C7=CC(=CC(=C7C8=C(C=CC(=C8)[C@H](C(=O)N6)NC(=O)[C@@H]4NC(=O)[C@@H]9C1=CC(=CC(=C1)O)OC1=C(C=CC(=C1)[C@H](C(=O)N[C@H](CC1=CC(=C(O3)C=C1)Cl)C(=O)N9)N)O)O)O[C@@H]1[C@H]([C@H]([C@@H]([C@H](O1)CO)O)O)O)O)C(=O)O)O[C@H]1[C@@H]([C@H]([C@@H]([C@H](O1)CO)O)O)NC(O)C)Cl)CO)O)O
Tetracycline	[H][C@@]12C[C@@]3([H])C(=C(O)[C@]1(O)C(=O)C(C(N)=O)=C(O)[C@H]2N(C)C)C(=O)C1=C(O)C=CC=C1[C@@]3(C)O
Thiocillin I	C/C=C/1\C2=NC(=CS2)C(=O)NC(C3=NC(=CS3)C(=O)NC(C4=NC(=CS4)C5=C(C=CC(=N5)C6=NC(=CS6)C7=NC(=CS7)C(=O)N/C(=C/C)/C(=O)NCC(C)O)C8=NC(=CS8)C(=O)NC(C(=O)N1)C(C)O)C(C)O)C(C)(C)O
Thiocillin II	C/C=C/1\C2=NC(=CS2)C(=O)NC(C3=NC(=CS3)C(=O)NC(C4=NC(=CS4)C5=C(C=CC(=N5)C6=NC(=CS6)C7=NC(=CS7)C(=O)N/C(=C/C)/C(=O)NCC(C)O)C8=NC(=CS8)C(=O)NC(C(=O)N1)C(C)O)C(C)OC)C(C)(C)O
Thiostrepton	CC[C@H](C)[C@H]1C(=O)N[C@H](C(=O)NC(=C)C(=O)N[C@H](C(=O)N[C@]23CCC(=N[C@@H]2C4=CSC(=N4)[C@H]([C@H](OC(=O)C5=NC6=C(C=C[C@H]([C@@H]6O)N1)C(=C5)[C@H](C)O)C)NC(=O)C7=CSC(=N7)[C@@H](NC(=O)[C@H]8CSC(=N8)/C(=C/C)/NC(=O)[C@@H](NC(=O)C9=CSC3=N9)[C@@H](C)O)[C@@](C)([C@@H](C)O)O)C1=NC(=CS1)C(=O)NC(=C)C(=O)NC(=C)C(=O)N)C)C
Tirandamycin	C[C@H]1[C@@H]2C(=O)[C@H]3[C@](O3)([C@@](O2)(O[C@@H]1[C@H](C)/C=C(\C)/C=C/C(=C\4/C(=O)CNC4=O)/O)C)C
Tuberactinomycin	C1[C@@H](NC(=N[C@H]1O)N)C2C(=O)NCC(C(=O)NC(C(=O)NC(C(=O)N/C(=C\NC(=O)N)/C(=O)N2)CO)CO)NC(=O)CC(C(CCN)O)N
Tyrocidine	CC(C)C[C@H]1C(=O)N[C@@H](C(=O)N2CCC[C@H]2C(=O)N[C@H](C(=O)N[C@@H](C(=O)N[C@H](C(=O)N[C@H](C(=O)N[C@H](C(=O)N[C@H](C(=O)N[C@H](C(=O)N1)CCCN)C(C)C)CC3=CC=C(C=C3)O)CCC(=O)N)CC(=O)N)CC4=CC=CC=C4)CC5=CC=CC=C5)CC6=CC=CC=C6
Vanconmycin	CN[C@H](CC(C)C)C(=O)N[C@@H]1[C@H](O)C2=CC=C(OC3=C(O[C@@H]4O[C@H](CO)[C@@H](O)[C@H](O)[C@H]4O[C@H]4C[C@](C)(N)[C@H](O)[C@H](C)O4)C4=CC(=C3)[C@@H](NC(=O)[C@H](CC(N)=O)NC1=O)C(=O)N[C@@H]1C3=CC(=C(O)C=C3)C3=C(O)C=C(O)C=C3[C@H](NC(=O)[C@@H](NC1=O)[C@H](O)C1=CC(Cl)=C(O4)C=C1)C(O)=O)C(Cl)=C2
Verdamicin	C[C@@H](C1=CC[C@H]([C@H](O1)O[C@@H]2[C@H](C[C@H]([C@@H]([C@H]2O)O[C@@H]3[C@@H]([C@H]([C@@](CO3)(C)O)NC)O)N)N)N)N
Viomycin	C1[C@@H](NC(=[NH+][C@H]1O)N)[C@H]2C(=O)NC[C@@H](C(=O)N[C@H](C(=O)N[C@H](C(=O)N/C(=C\NC(=O)N)/C(=O)N2)CO)CO)NC(=O)C[C@H](CCC[NH3+])[NH3+]
Virginiamycin	CC(C)[C@H]1OC(=O)C2=CCCN2C(=O)C2=COC(=N2)CC(=O)C[C@H](O)\C=C(/C)\C=C\CNC(=O)\C=C\[C@H]1C
Xenocoumacin 1	CC(C)CC(C1CC2=C(C(=CC=C2)O)C(=O)O1)NC(=O)C(C(C(CCCN=C(N)N)N)O)O
Xenocoumacin 2	CC(C)CC(C1CC2=C(C(=CC=C2)O)C(=O)O1)NC(=O)C(C(C3CCCN3)O)O
